{
  "histograms": {
    "0": {
      "0": 7713,
      "10": 644,
      "20": 61,
      "30": 14,
      "40": 5,
      "60": 1,
      "70": 1,
      "90": 1,
      "200": 1,
      "300": 1,
      "2070": 1
    },
    "1": {
      "0": 1148,
      "10": 460,
      "20": 175,
      "30": 71,
      "40": 45,
      "50": 23,
      "60": 18,
      "70": 10,
      "80": 11,
      "90": 4,
      "100": 6,
      "110": 4,
      "120": 2,
      "130": 1,
      "140": 1,
      "150": 2,
      "160": 1,
      "170": 1,
      "200": 1,
      "210": 1,
      "220": 1,
      "230": 1,
      "260": 1,
      "270": 1,
      "280": 3,
      "350": 1,
      "360": 1,
      "440": 1,
      "490": 1,
      "500": 1,
      "610": 1,
      "630": 1,
      "1760": 1,
      "2620": 1,
      "2680": 1,
      "4700": 1
    },
    "2": {
      "0": 844,
      "10": 29,
      "20": 9,
      "30": 14,
      "40": 11,
      "50": 12,
      "60": 8,
      "70": 10,
      "80": 4,
      "90": 4,
      "100": 7,
      "110": 2,
      "120": 7,
      "130": 7,
      "140": 2,
      "150": 1,
      "160": 2,
      "170": 1,
      "180": 2,
      "190": 2,
      "200": 1,
      "210": 1,
      "230": 1,
      "240": 1,
      "250": 1,
      "270": 1,
      "290": 1,
      "340": 2,
      "360": 1,
      "400": 1,
      "470": 1,
      "530": 1,
      "540": 1,
      "550": 1,
      "700": 1,
      "770": 1,
      "780": 1,
      "830": 1,
      "850": 1,
      "890": 1,
      "910": 1,
      "1010": 1,
      "1160": 1,
      "1420": 1,
      "1680": 1,
      "2100": 1,
      "2310": 1,
      "3170": 1,
      "3730": 1,
      "4850": 1
    },
    "3": {
      "0": 842,
      "10": 10,
      "20": 2,
      "50": 1,
      "80": 1,
      "90": 1,
      "100": 1,
      "130": 1,
      "140": 2,
      "150": 1,
      "170": 1,
      "190": 2,
      "200": 2,
      "230": 1,
      "250": 3,
      "290": 1,
      "300": 1,
      "310": 1,
      "340": 1,
      "370": 1,
      "390": 1,
      "400": 1,
      "430": 1,
      "440": 1,
      "480": 1,
      "530": 1,
      "590": 1,
      "600": 1,
      "710": 1,
      "880": 1,
      "900": 1,
      "1100": 1,
      "1180": 1,
      "1240": 1,
      "1690": 1,
      "2260": 1,
      "2310": 1,
      "2730": 1,
      "2790": 1,
      "2940": 1,
      "3270": 1,
      "3730": 1,
      "4850": 1
    }
  },
  "metadata": {
    "intermediateCommunities": 4,
    "communityCount": 1,
    "intermediateCounts": [
      8443,
      2003,
      1009,
      899
    ]
  }
}